○–■■–■–■–■–––––
■––––––––■■–■–■
–■–■■–■■––■–■––
–■–■–––■■–■––■–
––––■–■–––■■–■–
–■–■––■–■■–––■–
–■–■■■■–■––■■■–
■–––■–––––■––––
■–■–■–■–■––■■–■
––■–––■■■■––––■
■––■■–■–■■–■■––
■■––■––––––––■–
■■–■––■■–■■■■––
–––––■■––■––■–■
■–■■–––■––■–––◘
